**********
*P       *
*    **  *
*        *
*        *
*        *
* *   ** *
*      O *
*        *
**********