**********
*P       *
*     *  *
*        *
*   *    *
*        *
* *   *  *
*      O *
*        *
**********